###########
#S#       #
# ##### # #
# #   # # #
# # # ### #
#   #     #
######### #
# #       #
# # # #####
#   #    E#
###########
